                 #     #             #   #         
 ############### # ### # ##### ##### # # # ####### 
     #             #   #   #   #   # # #   #     # 
 ### ############### ####### ##### # # ##### ### ##
   #             #           #     # #     #   #   
## ############# # ############# # # # ### ### ### 
   #   #     # # # #   # #       # # # # #   # # # 
 ##### # # # # # ### # # # # ##### # # # ### # # # 
     #   # #   #     # #   # #     # # #   # # # # 
#### ##### ### ####### # ### ### ### # # # # # # # 
     #     #   #       #   #   #   # #   # #     # 
 ##### ##### ### ### ######### ##### # ####### ### 
   #   #   # #   #   #   #   #       # #     # #   
## # # ### # # ### ### # # # # ######### ### # # # 
   # # #   # #   #   # #   # #     #     # # # # # 
 ##### # ### ### ##### ##### ##### # # ### # # # ##
 #     # #     #     #     #   # # # # # #   # #   
 # # ### # ##### ### ##### ### # # ### # # ### ### 
 # # #   # #   #   #     #   # # #     #   #     # 
 ### # # # # # ####### # ### # # ####### ######### 
   # # #   # # #       #   # # #       #     #   # 
## # # ##### # # ######### # # # ### ####### # # # 
 #   #     # #   #         # # #   #       #   #   
 ######### # ######### ##### # ### ### ########### 
     #     #     #   # #     #   #   # #         # 
 ### # ######### # # ### ### ### ### # # ####### # 
 # # #     #   # # #     # #   #   # #         #   
 # # ##### ### # # ####### ### ### # ############# 
 # # #   #   # #   # #     #   #   #   #         # 
 # # # # ### # ##### # ##### ### ####### ##### # ##
   # # #     #       # #     #   #   #   #   # #   
#### # ####### ##### # ### ### ### # # ### # ##### 
     # #       # #   #   #   #     #     # #     # 
 ##### # ##### # # ##### ### ############# ##### # 
     # # #   # # # #   # #         #       # #   # 
 ### # ### # # # # # # # ########### ####### # ### 
 #   #     #   # #   # #     #       #         #   
## # ########### ##### ##### # ####### ########### 
   #     #       #   #     # #   #     #           
 ####### ##### # ### ##### # ### # ######### # ####
 #     #       #     #   # #   # # #       # # #   
 ### # ####### ####### # # ### # # # # ### ### # # 
   # # #       #       # #   # # # # # # #   # # # 
 # # ### ####### ####### ### # # # ### # ### # ### 
 # #     # #   #     # #     #   #   # #   #   #   
 # ### ### # # ##### # ############# # # # ##### # 
 #   #     # #     # #       #     #   # #   #   # 
 ### ####### ##### # ##### # ##### ##### ### # ### 
 # # #     #   # # # #   # #       #   # #   # #   
 # # # ### ### # # # # # # ####### # # # # ### # ##
   #     #       #     #   #         #   #     #   
