       #       #       # #     
 # ### ##### # ##### # # # # ##
 #   #   #   #       # # # #   
 ### ### # ########### # # ### 
 # # #     #     #     #   #   
 # # ######### ### ##### ### # 
 # #     #     #   #       # # 
 # ##### # # ### ########### # 
 #     # # #   #       #     # 
 # ### # ##### ####### # ######
 #   # #     #   #     # #     
 ### # ##### # # # ##### # ### 
     # #     # # # #     # # # 
 ##### # ##### # # ### # # # # 
 #   # # #     #     # # # #   
 # # ### ########### ### # # ##
 # #   #     #   #       # # # 
## ### ##### # ######### # # # 
   # #       #       #   # # # 
 ### # ############# # ### # # 
 #     #           # # #   # # 
 ### ### ####### # # ### ### # 
   #   #   #     # #     # # # 
 # ####### # ### ######### # # 
 #         # #   #         # # 
 ########### ##### ####### # # 
 #       # #       #   # # #   
 # ##### # ######### # # # ### 
   #   #     #       # # #   # 
#### ####### ####### # # ### # 
                     #     #   
